; Main world (20x20)
size 20 20
chunk_size 20

chunk 0 0
....................
....ssssssss........
....s......s........
....s..ww..s........
....s..ww..s........
....s......s........
....ssssssss........
....................
......~~~~~~........
....................
....................
....................
....wwwwwwww........
....w..B..w.........
....w..B..w.........
....w..B..w.........
....wwwwwwww........
........T...........
....................
....................
