; Mini room - Nook (20x20)
size 20 20
chunk_size 20

chunk 0 0
####################
#..................#
#..wwwwwwww........#
#..w......w........#
#..w.BBB..w........#
#..w.BBB..w........#
#..w......w........#
#..wwwwwwww........#
#..................#
#.....~~~~.........#
#.....~SS~.........#
#.....~~~~.........#
#..................#
#....T.............#
#..................#
#..................#
#..................#
#..................#
#..................#
####################
