; Mini room - Vault
size 20 20
chunk_size 20

chunk 0 0
####################
#..................#
#..ssssssssssss....#
#..s..........s....#
#..s..BBBBBB..s....#
#..s..B....B..s....#
#..s..B.T..B..s....#
#..s..B....B..s....#
#..s..BBBBBB..s....#
#..s..........s....#
#..ssssssssssss....#
#..................#
#....~~~~~~........#
#....~SSSS~........#
#....~~~~~~........#
#..................#
#........T.........#
#..................#
#..................#
####################
